0 x*** -> N 0
0 N*** -> X 1

1 **x* -> W 1
1 **W* -> E 2
2 *x** -> E 2
2 *E** -> S 1